1111111111111111111111111111111
1PCCCCC1CC0CCC111000CCCC1C101C1
100000010000111110000000100C101
1C0011000000E100000C00001010001
1C0000011000000000000C0000101C1
1111111111111111111111111111111