111111111111
111110011111
110000E11111
1101100C1111
110111111111
110111111111
110000001111
111111101111
1111111P1111
111111101111
111111101111
111111111111
111111111111