1111111111
10000E1001
1001001C01
1001111101
1001000001
1001000001
1001010111
100101P001
1001010001
1111111111