1111111111
10000E0001
1001000C01
1001111101
1001000001
1001000001
1001010111
100101P000
1001010001
1111111111