NO img/backroom/Backroom_Wall.xpm
SO img/backroom/Backroom_Wall.xpm
WE img/backroom/Backroom_Wall.xpm
EA img/backroom/Backroom_Wall.xpm

F 129,110,30
C 195,203,110

111111111111111111111
100000000000000000001
100000000000000000001
100000000000000000001
100000000000000000001
100000000000000000001
100000000000000000001
100000000000000000001
100000000000000100001
100000000000000000001
1000000000N0001110001
100000000000000000001
100000000000000000001
100000000000000000001
100000000000000000001
100000000000000000001
100000000000000000001
100000000000000000001
100000000000000000001
100000000000000000001
111111111111111111111
