NO img/backroom/Backroom_Wall.xpm
SO img/backroom/Backroom_Wall.xpm
WE img/backroom/Backroom_Wall.xpm
EA img/backroom/Backroom_Wall.xpm

F 129,110,30
C 195,203,110

        111111 111111111111111111
        100001 100000000000000000
        1000011100000000000000001
        1000000000000000000000001
111111111000000000000000000000001
100000000000000000000000000011111
10000000000000000000000000001
10000000000000000000000000001
10000000111000000000000000001
100N00001 1000000000000000001
10000000111000000000000000001
11000000000000000000000000001
 11100011110000011100000000011111
   10001  1000101 100000000000001
   11111  1111111 111111111111111