NO ./img/test/NO.xpm
SO ./img/test/SO.xpm
WE ./img/test/WE.xpm
EA ./img/test/NO.xpm

F 130,130,160
C 200,200,180

        111111 111111111111111111
        100001 100000000000000001
        1000011100000000000000001
        1000000000000000000000001
111111111000000000000000000000001
100000000000000000000000000011111
10000000000000000000000000001
10000000000000000000000000001
10000000111000000000000000001
100N00001 1000000000000000001
10000000111000000000000000001
11000000000000000000000000001
 11100011110000011100000000011111
   10001  1000101 100000000000001
   11111  1111111 111111111111111